 .                                   .  . 
       .  .  .  .  .  .  .  .  .        . 
    .  .  .  .  .  .  .  .  .  .  .     . 
    .  .  .  .  .  .  .  .  .  .  .       
    .  .  .  .  .  .  .  .  .  .  .  .    
    .  .  .  .  .  .  .  .  .  .  .  .    
    .  .  .  .  .  .  .  .  .  .  .  .    
    .  .  .  .  .  .  .  .  .  .  .  .    
    .  .  .  .  .  .  .  .  .  .  .  .    
    .  .  .  .  .  .  .  .  .  .  .  .    
       .  .  .  .  .  .  .  .  .  .  .    
 .        .  .  .  .  .  .  .  .        . 
 .  .     .  .  .  .  .  .  .        .  . 



 checked and safe: [  ]   checked and obstacle [ x ]   unchecked [ . ]
